Maze1
7,6 
1,1,1,1,1,1
1,0,1,1,0,1
1,0,0,0,0,1
1,1,1,0,0,0
1,0,1,1,0,1
1,0,0,1,0,1
1,1,1,1,1,1
3 
1,2 
5,3
4,1
Maze2 
3,10
1,1,1,1,1,1,0,1,1,1
1,0,0,1,1,0,0,1,1,1
1,1,1,1,1,1,1,1,1,1
2
1,1
1,5
maze1
6,5
1,1,1,0,1
1,0,0,0,1
1,0,1,0,1
1,0,1,0,1
1,0,0,0,1
1,1,1,1,1
2
1,1
4,1
maze2
6,6
1,1,1,1,1,1
1,0,0,0,0,1
1,0,1,1,0,1
1,0,0,0,0,1
1,0,1,1,1,1
1,0,1,1,1,1
2
1,4
3,3
maze4
16,10
1,1,1,1,1,1,1,1,1,1
1,1,1,1,1,1,1,0,1,1
1,1,1,1,1,1,1,0,1,1
1,1,1,1,1,0,0,0,0,1
1,1,1,1,1,0,1,1,0,1
1,0,0,0,0,0,1,1,0,1
1,1,0,1,1,0,1,1,0,1
1,1,0,1,1,1,1,1,0,1
1,0,0,0,1,1,1,1,0,1
1,0,1,1,1,1,1,1,0,1
1,0,1,1,1,1,0,1,0,1
1,0,0,0,1,1,0,1,0,1
1,1,1,0,1,1,0,0,0,1
1,1,1,0,1,1,0,1,1,1
1,1,1,0,0,1,0,0,1,1
1,1,1,0,1,1,1,1,1,1
3
1,7
10,8
8,3
maze5
16,10
1,1,1,1,1,1,1,1,1,1
1,1,1,1,1,1,1,0,1,1
1,1,1,1,1,1,1,0,1,1
1,1,1,1,1,0,0,0,0,1
1,1,1,1,1,0,1,1,0,1
1,0,0,0,0,0,1,1,0,1
1,1,0,1,1,0,1,1,0,1
1,1,0,1,1,0,1,1,0,1
1,0,0,0,1,0,1,1,0,1
1,0,1,1,1,0,1,1,1,1
1,0,1,1,1,0,0,1,0,1
1,0,0,0,1,1,0,1,1,1
1,1,1,0,1,1,0,0,0,1
1,1,1,0,1,1,0,1,1,1
1,1,1,0,0,1,0,0,1,1
1,1,1,0,1,1,1,1,1,1
3
1,1
1,7
10,8